  10:10:0:310:310:4
 


 int[][] matriz = {
        {0, 1, 1, 1, 1, 1, 0, 0, 1, 1},
        {0, 1, 0, 1, 0, 1, 1, 1, 1, 0},
        {0, 1, 1, 0, 0, 0, 0, 0, 1, 0},
        {0, 0, 1, 0, 1, 1, 1, 0, 1, 0},
        {0, 0, 1, 0, 1, 0, 1, 0, 1, 0},
        {1, 1, 1, 0, 1, 0, 1, 0, 1, 0},
        {0, 1, 0, 0, 1, 0, 1, 1, 1, 0},
        {0, 1, 0, 0, 1, 0, 0, 0, 0, 0},
        {0, 1, 1, 1, 1, 0, 1, 1, 0, 0},
        {0, 0, 0, 0, 1, 1, 1, 0, 0, 0},};
