11161110161110111113
10001010001010100060
11101011111010101010
00001000000010101010
11111011101110101110
10000010101000100000
00111110111016116111
10100000000000100000
10101111101110101160
60101000101010101010
11101110101010111011
10006010101010100000
11611010111010111110
10000010000010000060
11111011111011111161
00001000001000000060
11101011101011111110
10101010101010000010
10001010101010111110
11161110111010000000
