11161110161111111110
10001010001000000010
16101010111011111061
00101010100010001000
11101010101110101110
10001010101000600010
11111010101110111010
10000010100010101010
11101110111010101110
10101000001010100060
10101111111010111000
10100000000010001013
10101111101611101010
10101000100000101010
10111061111111101010
10000010000000001010
10111111111011101010
10100000001010101010
10101111161110161110
11111000000060000000