111100101110113
010600101010100
010101601011100
060101001000000
010111001111100
110006001000161
011116001000000
010010001111100
010011611000100
010000001010611
010101111010000
010101000010061
010601001111110
010111101001000
011100111001611
