
 int  cantidadColumnas= 15;
  int cantidadFilas= 15;
  int tamanoPieza= 0;
  int anchoPanel= 460;
  int altoPanel = 460;
  int anchoSombra = 4;




 int[][] matriz = {
        {0, 1, 1, 1, 0, 0, 1, 0, 1, 1, 1, 0, 1, 1, 1},
        {0, 1, 0, 1, 0, 0, 1, 0, 1, 0, 1, 0, 1, 0, 0},
        {0, 1, 0, 1, 0, 1, 1, 0, 1, 0, 1, 1, 1, 0, 0},
        {0, 1, 0, 1, 0, 1, 0, 0, 1, 0, 0, 0, 0, 0, 0},
        {0, 1, 0, 1, 0, 1, 0, 0, 1, 1, 1, 1, 1, 0, 0},
        {0, 1, 0, 0, 0, 1, 0, 0, 1, 0, 0, 0, 1, 1, 0},
        {1, 1, 1, 1, 1, 1, 0, 0, 1, 0, 0, 0, 0, 0, 0},
        {0, 1, 0, 0, 1, 0, 0, 0, 1, 0, 1, 1, 1, 0, 0},
        {0, 1, 0, 0, 1, 1, 1, 0, 1, 0, 0, 0, 1, 0, 0},
        {0, 1, 0, 0, 0, 0, 0, 0, 1, 0, 1, 0, 1, 1, 1},
        {0, 1, 0, 1, 0, 1, 1, 1, 1, 0, 1, 0, 0, 0, 0},
        {0, 1, 0, 1, 0, 1, 0, 0, 0, 0, 1, 0, 0, 1, 0},
        {0, 1, 0, 1, 0, 1, 0, 0, 1, 1, 1, 1, 1, 1, 0},
        {0, 1, 0, 1, 1, 1, 1, 0, 1, 0, 0, 1, 0, 0, 0},
        {0, 1, 1, 1, 0, 0, 1, 1, 1, 0, 0, 1, 1, 1, 1}
    };
