6106110113
0101010100
0111060101
0000010101
0111610101
1100000101
0101111101
0101000011
0111116000
0600001160