1116110013
0601016110
0110000010
0010111010
0010101010
1110101010
0100101116
0100100000
0111106111
0000111000
