111111111010111
100000100010100
111010111011100
101010001000000
001110111011111
101000101010000
111011101011110
000010000000010
111110111111110
100000100000000
111110101111011
100010100000010
101110101111110
101000101000000
101111111011110
