11611110111110111111
10001010001010100010
11101011111010101010
00001000000010101010
11111011101110101110
10000010101000100000
10111110111011111111
10100000000000100000
10101111101110101110
00101000101010001010
11101110101010111011
10001010101010100000
10111010111010111110
10000010000010000010
11111011111011111111
00001000001000000010
11101011101011111110
10101010101010000010
10001010101010111110
11111110111010000000
