111161161010111
100000100010100
161011111011100
601010001000000
001110111011113
101000106010000
111011101011110
000010000000010
111110111111110
100000100000000
111110101111061
600010100000010
101110101111110
101000101000000
101111111011111
