0111110013
0101011110
0110000010
0010111010
0010101010
1110101010
0100101110
0100100000
0111101100
0000111000
